14 15 14 14 15 14 15 14 14 15 14 14 14 14 15 14
14 15 14 14 15 14 15 14 14 15 14 14 14 14 15 14
14 15 14 14 15 14 15 14 14 15 14 14 14 14 15 14
14 15 14 14 15 14 15 14 14 15 14 14 14 14 15 14
14 15 14 14 15 14 15 14 14 15 14 14 14 14 15 14
14 9 10 11 12 13 15 15 14 15 14 9 10 11 12 13
5 8 8 7 8 8 7 8 8 6 8 8 7 8 5 8
8 7 8 6 8 8 6 8 8 7 8 5 8 8 7 8
7 8 5 8 8 7 8 8 5 8 8 6 7 8 5 8
0 2 1 0 0 2 1 2 0 2 0 1 0 2 1 0
7 8 8 7 5 8 8 7 8 7 8 8 5 7 8 8
6 7 8 8 7 8 7 8 8 6 8 7 8 8 7 8